@corinnamilborn Liebe Corinna, wir wÃ¼rden dich gerne als Moderatorin fÃ¼r uns gewinnen! WÃ¤rst du begeisterbar?	OTHER	OTHER
@Martin28a Sie haben ja auch Recht. Unser Tweet war etwas missverstÃ¤ndlich. Dass das BVerfG Sachleistungen nicht ausschlieÃŸt, kritisieren wir.	OTHER	OTHER
@ahrens_theo frÃ¶hlicher gruÃŸ aus der schÃ¶nsten stadt der welt theo âš“ï¸	OTHER	OTHER
@dushanwegner Amis hÃ¤tten alles und jeden gewÃ¤hlt...nur Hillary wollten sie nicht und eine Fortsetzung von Obama-Politik erst recht nicht..!	OTHER	OTHER
@spdde kein verlÃ¤ÃŸlicher Verhandlungspartner. Nachkarteln nach den SondierzngsgesprÃ¤chen - schickt diese StÃ¼mper #SPD in die Versenkung.	OFFENSE	INSULT
@Dirki_M Ja, aber wo widersprechen die Zahlen denn denen, die im von uns verlinkten Artikel stehen? In unserem Tweet geht es rein um subs. GeschÃ¼tzte. 2017 ist der gesamte Familiennachzug im Vergleich zu 2016 - die Zahlen, die Hr. Brandner bemÃ¼ht - Ã¼brigens leicht rÃ¼cklÃ¤ufig gewesen.	OTHER	OTHER
@milenahanm 33 bis 45 habe ich noch gar nicht gelebt und es geht mir am Arsch vorbei was in dieser Zeit geschehen ist. Ich lebe im heute und jetzt und nicht in der Vergangenheit.	OFFENSE	PROFANITY
@jayxderxmensch @jayxthexhuman Wieso? Was findest du da unklar?	OTHER	OTHER
@tagesschau Euere AfD Hetze wirkt. Da kÃ¶nnt ihr stolz sein bei #ARD-Fernsehen	OFFENSE	ABUSE
Deutsche Medien, Halbwahrheiten und einseitige Betrachtung, wie bei allen vom Staat finanzierten "billigen" Propagandainstitutionen ğŸ˜œ	OFFENSE	ABUSE
@AJCBerlin @AuswaertigesAmt Er hat heute morgen auch SchÃ¤uble getroffen. Das ist einfach nur unfassbar	OTHER	OTHER
@Ralf_Stegner Oman Ralle..dich mag ja immer noch keiner. Du willst das die Hetze gegen dich aufhÃ¶rt? |LBR| Geh in Rente und verzichte auf die 1/2deiner Pension	OFFENSE	INSULT
Klausurtagung der CSU hat eher Fragezeichen vermehrt, ob Union die Kraft hat, die erforderlichen VerÃ¤nderungen von Europa bis Digitalisierung, bei Arbeit und Rente, bei Bildung und Familie, bei Gesundheit und Wohnen, bei Pflege und Steuern, bei Integration etc. anzugehen.	OTHER	OTHER
Den TÃ¼rken ist die SouverÃ¤nitÃ¤t der Niederlande egal. Sie wollen dort |LBR| bestimmen. So geht das nicht. Ausweisen, wem das nicht passt.	OTHER	OTHER
@L7250402 @RGutmensch Auweia. Es geht nicht darum, dass man uns "toll" finden muss. Aber man kÃ¶nnte zumindest versuchen zu verstehen, was wir machen und wie wir das finanzieren, bevor man einfach falsche Schlussfolgerungen zieht und diese schamlos verbreitet. Schafft aber scheinbar nicht jeder.	OTHER	OTHER
@DietmarBartsch @DJanecek Na, geht doch. Jetzt muss noch @SWagenknecht in einer Nachtsitzung Angela Merkel die Obergrenze abhandeln, dann kann Schwarz-GrÃ¼n-Dunkelrot noch vor Weihnachten die Amtseide ablegen.	OTHER	OTHER
FÃ¼r mich ist der morgige Tag ein Tag der "GrÃ¶ÃŸten Deutschen Schweinerei" seit 1945, eine riesen Mogelpackung bekloppter PolitikerğŸ¤¢	OFFENSE	ABUSE
@SteinbachErika Das lassen die ğŸ‡©ğŸ‡ª nicht zu....und wenn sie gegen ihren eigenen Willen festgehalten werden... |LBR| Es ist leicht nach ğŸ‡©ğŸ‡ªeinzureisen...aber raus?	OTHER	OTHER
@Steinhoefel Ich finde deutsche haben noch eine Chance verdient...auch wenn ich ein Teil meiner Landsleute nicht besonders mag, aber sie sollten nochmals wÃ¤hlen dÃ¼rfen...!	OTHER	OTHER
#Dieselgipfel: Automobilindustrie muss Schadstoffe reduzieren â€“ schnell, gesetzestreu, technisch sauber und transparent nachvollziehbar (2)	OTHER	OTHER
@peter2018huber @YouTube Das sitzt die doch aus - Teflon-Merkel ist ihr Spitzname in der Schweiz - an der prallt alles ab.	OTHER	OTHER
@Beutebadener @LeggaKnoppers @KotzenderStern Was laberst du jetzt von.inzucht schau mal an was dein schÃ¶nes multikulti mit Deutschland gemacht hat	OTHER	OTHER
@JensMeding Hast Du schon das Initiationritual hinter Dir?	OTHER	OTHER
Diese Woche hatten wir die Gelegenheit uns mit 4 kurdischen BÃ¼rgermeister*innen der HDP zu vernetzen! @LeylaImret @coban95	OTHER	OTHER
@DasErste Danke fÃ¼r die schnelle Info , aber eure Unterschlagungen von wichtigen Nachrichten in der Tagesschau machen euch zum Helfer von Terroristen in Deutschland.BÃ¼rger in Sicherheit wiegen die nicht vorhanden ist!	OTHER	OTHER
Du sollst keinen anderen Gott haben neben mir. Mal schauen wann Gottes Worte als Rassismus dargestellt werden.	OTHER	OTHER
@krippmarie Ich kenne noch einige Namen unter den SPDler die ebenfalls zu Grabe getragen mÃ¼ssten-sollten-werden....	OFFENSE	ABUSE
Wir geben unsere IdentitÃ¤t nicht auf. Bedenke das Ende bei all dieser Beliebigkeit. #islamfeiertag	OTHER	OTHER
@StephanJBauer @soskinderdorf Auch in Deutschland hungern Kinder.	OTHER	OTHER
@5junx Und hÃ¤tten wir regiert und alle Zusagen gebrochen, dann wÃ¤re hier heute von Umfallen und Postengeilheit die Rede gewesen! ğŸ˜‚ #Beliebigkeit CL	OTHER	OTHER
#Trump ist als Politiker kein SchwÃ¤tzer sondern handelt vom ersten Tag an. |LBR| Und geopolitisches Denken des letzten Jahrhunderts ist ihm fremd	OTHER	OTHER
In Abwandlung der Kanzler Worte sage ich: |LBR| CDU SPD-folgt diesen Leuten nicht, sie regieren schon immer und die Armutschere ist grÃ¶ÃŸer denn je	OTHER	OTHER
@ndaktuell Ach Gott mehr nicht,was gedenkt man dagegen zutun,nach dem GG dÃ¼rfen nur Deutsche StaatsbÃ¼rger protestieren .Was hier geschehen ist ,ist ein Aufstand von Radikalen Moslems ,da sage ich nur einsammeln und Heimschicken!	OFFENSE	ABUSE
Die Zahl arabischer Rekruten in der israelischen Armee steigt rasant. Die @BBC hat eine Dokumentation Ã¼ber sie gedreht. #Israel @BBCArabic	OTHER	OTHER
@WWF_Deutschland Kein Kohleausstieg,wenn dadurch unsichere Atomenergie aus dem Ausland importiert werden muss.Unsere sicheren Atomkraftwerke werden abgeschaltet und unsichere im Ausland gebaut.Auch die WinkraftrÃ¤der sind nur eine Verschandelung der Natur.Das Ausland lacht.	OTHER	OTHER
@krippmarie Die Deutschen checken es einfach nicht	OTHER	OTHER
@ShakRiet @Heinrich_Krug So ist es....wir haben Maria vergessen...als hÃ¤tte sie nie existiert....schÃ¤mt euch...!	OTHER	OTHER
@hortarimar @Georg_Pazderski Dann kÃ¶nnen wir vielleicht eine konstruktive Diskussion fÃ¼hren. Wenn Sie mit Unterstellungen arbeiten, dann wird das nicht mÃ¶glich sein. Wir laden Sie zu einem virtuellen tÃ¼rkischen Tee ein.	OTHER	OTHER
@LgJohnSilver HÃ¶chste Zeit und in gemeinsamer internationaler Kraftanstrengung, sowie gebotener HÃ¤rte.	OTHER	OTHER
@Uwe_Junge_MdL @krippmarie Die Deppen der Nation....Ã–sterreicher lachen am lautesten....ğŸ˜ƒğŸ˜ƒ	OTHER	OTHER
@pinselpoetin Ich lernte im Jurastud. noch,dass d. TÃ¤ter nicht therapierbar sind,was d. Praxis meistens beweist. Ewig aus dem Verkehr ziehen	OTHER	OTHER
@BlauekeP @poschuetzge @lawyerberlin @Die_Gruenen @fdp Hubertus....was hab ich mit Adolf zu tun? |LBR| Und ich erstarre bei beim Wort Nazi auch nicht in SchuldgefÃ¼hlen wie der Rest nur weil ichğŸ‡©ğŸ‡ªliebe	OFFENSE	ABUSE
@Einzelfallinfos @Carolin94815291 Das ist in Deutschland nicht strafbar...nur wenn deutsche DiebstÃ¤hle begehen dann ist es anders...	OTHER	OTHER
@monikabergholz2 Wir haben keine Meinungsfreiheit ,von wem soll die auch kommen wenn man eine in der DDR ausgebildete Bundeskanzlerin hat .Mielke hÃ¤tte sich totgelacht.Ich glaube am Grab hÃ¶rt man in ğŸ‰	OFFENSE	ABUSE
@Einzelfallinfos @FfFrauki Wir sind nunmal Weltmeister...in Aufarbeitung....aber endlose Pfeifen in Vorkehrungen. |LBR| Ich halte alle Politiker fÃ¼r Helfershelfer....sie gehÃ¶ren auf die Anklagebank und nicht in Ã¼berbezahlten Ruhestand...! |LBR| @AfD .....	OTHER	OTHER
@Nils_puels @marcobuelow ich glaube wirklich das ein mitgliederentscheid die partei eint ğŸ‘	OTHER	OTHER
@ulfposh Doch nicht nur die Planeten! Es geht um das Leben, das Universum und den ganzen Rest. |LBR| Ich muss jetzt los, die MilchstraÃŸe retten.	OTHER	OTHER
Infotweet: Antifaschisten sind alle vernachlÃ¤ssigte Scheidungskinder	OFFENSE	INSULT
Was machte Luther eigentlich an einem BrÃ¼ckentag? Und was wÃ¼rde er heute Ã¼ber die TÃ¼rken und die Juden sagen? |LBR| #Reformation_neu_denken!	OTHER	OTHER
@MartinaRenner @dieLinke Und die Linken Anarchisten Ã¼ben in Hamburg ğŸ‘ŠğŸ”¥	OFFENSE	ABUSE
Zur ErÃ¶ffnung der #Israelpedia sind unsere Gedanken bei den Menschen in Israel |LBR| #DIG #Frankfurt #Israel	OTHER	OTHER
@gerdm4863 Das ist einfach so...aber noch lange kein Grund Deutschland mit fremden MÃ¤nnern zu fluten....	OFFENSE	ABUSE
@Ami66Stefan Juden und Christen werden als Schweine und Affen bezeichnet.. Aber das steht ja nur im Koran. Die Suren erspare ich mir jetzt. Lesen.....	OFFENSE	ABUSE
@anna_IIna Kann man diesen ganzen ScheiÃŸ noch glauben..?	OFFENSE	PROFANITY
@welt Bla bla bla! LÃ¼genpresse verkauft uns mal wider fÃ¼r Dumm! Alles gespieltes Theater!!	OFFENSE	ABUSE
@OnlineMagazin Das kann doch nur ein Fake sein !!! Die sind sowenig DEUTSCH wie Erdogan ! Nu gehts wirklich los ! Auch im TV der MSM nur noch NICHTDEUTSCHE ! ğŸ¤¬ğŸ¤¬ğŸ¤¬â˜ ï¸â˜ ï¸â˜ ï¸ğŸ¤¬ğŸ¤¬ğŸ¤¬	OFFENSE	ABUSE
Afghanistan ist ein sicheres Land, wenn Deutschland, England u. |LBR| Frankreich als sicher bezeichnet werden. Leider gab es AnschlÃ¤ge.	OTHER	OTHER
#illner Das SÃ¶der nun auf #AfD Programm macht und die Wahrheit ausspricht,welche nur bei der AfD rassistisch und polemisch,bei SÃ¶der aber "bÃ¼rgernahe Erkenntnis" ist,scheint #87Prozent Ã¼berhaupt nicht zu stÃ¶ren. |LBR| Ja...so sind sie.Die Heuchler und Doppelmoraler.	OFFENSE	INSULT
@Regendelfin Sind selbst Schuld die Dummen Girlies die unbedingt Modell werden wollen,	OFFENSE	INSULT
@NorgePrivacy @krippmarie SpÃ¤testens seit BlÃ¼mchen wissen wir welche Waschlappen in der Regierung sitzen....ğŸ˜ƒğŸ˜ƒ	OFFENSE	INSULT