@RT_Deutsch Journalisten sollten bei der Wahrheit bleiben	OTHER	OTHER
Man hat sich nicht umsonst ein krankes M√§dchen als Zugpferd dieser Kampagne ausgesucht, |LBR| um jeder Kritik daran als pers√∂nlichen Angriffe auf #GretaThunberg zu werten. Neuerdings auch rechter Hass genannt!üòÇüòÇ	OTHER	OTHER
@TobiBernet Dazu der Gedanke, was ein Outing in einer gesellschaftlichen Realit√§t wie in Chemnitz bringt. Ich finde au√üerdem zu viel Smoke & Mirrors f√ºr das Thema	OTHER	OTHER
@drumheadberlin @BILD_Politik Ich komme aus seinem Wahlkreis. 1979, zur ersten Europawahl, hatte ich ihn noch gew√§hlt. Da war er 31 Jahre jung. Ich wusste damals noch nicht, dass er ein Bertelsmann-Lobbyist ist. Heute ist er ein alter, m√ºder und oft peinlicher Mann, und kann immer noch nicht loslassen.	OFFENSE	INSULT
Diese Woche im AZ Aachen: |LBR| Di., 27.3., 20:30 Uhr: |LBR| ¬∞2h PARTY Filqsa¬∞ |LBR| Mi. 28.3., 21 Uhr: |LBR| MoFo & The Sexy Humans und H4CK |LBR| Do., 29.3., 20 Uhr: |LBR| Tides!, Hal Johnson & Snareset	OTHER	OTHER
Mohammed bin @Salman hat islamische Rechtswissenschaft ( Auftragskiller ) studiert	OFFENSE	ABUSE
@hose_hans @ichbinschoener @welt Womit wir wieder den #Broder in dir geweckt haben, aber du w√§rst nicht der erste D√ºmmling den seine Selbst√ºbersch√§tzung den Kopf gekostet hat! Viel Spa√ü dabei!üòÇüòÇ	OFFENSE	INSULT
Mit der weiblichen Scheixxe? |LBR| Baby Massenm√∂rderinnen. Widerlichst verlogen. Wei√üe M√§nner, speziell V√§ter hintertreibend. |LBR| Wird nichts mehr. |LBR| Westl. Frauen stinken nach bigott verlogener Selbstgerechtigkeit. |LBR| Und die Vergewaltigungen und Tote? Haben sie sich selbst zu entschieden.	OFFENSE	ABUSE
@ArmesDeutschla6 @Hartmut73 @jouwatch War doch vorraus zu sehen was die Linksfaschisten machen kotze gleich	OFFENSE	INSULT
Hallo, ihr kleinen, h√§sslichen BINSENWOMBATS!	OFFENSE	PROFANITY
@Alice_Weidel Sofort diese M√∂rder und Bastarde d√ºrfen keinen Cent mehr bekommen	OFFENSE	INSULT
@Telekom_hilft Ja! Ich HABE Langeweile! |LBR| Und diese nennt sich @Telekom_hilft !! |LBR| Sie kleine vegane Binsen-Wombatsine!!	OFFENSE	INSULT
@jouwatch Und wer sind die Nazis ?	OTHER	OTHER
Ab 3.20 Uhr (Winterzeit/4.20 Uhr Sommerzeit) ist das AZ wieder geschlossen. Kommt gut durch die Nacht! Und vergesst Sonntag nicht den Gesa-Support: @AcGesa! #endegelaende #aachen #hambacherforst #aachen @Ende__Gelaende @HambiBleibt @EAHambi @MahnwacheHambi	OTHER	OTHER
Ja @facebook ihr seit wie Merkel , ihr passt auch in jedes Arschloch	OFFENSE	INSULT
@Darth_Lehrer M√ºssen Sie h√§sslicher s√ºdost-westf√§lischer Binsenwombat mir alles kaputt machen?!! |LBR| Und jetzt SCHNAUZE! Star Trek l√§uft.	OFFENSE	INSULT
Nicht nur Poroschenko verdient gut ,auch Deutsche Politiker verdienen gut an das Schwarzgesch√§ft R√ºstung	OFFENSE	INSULT
08:26 Now we are open again. Wir haben jetzt wieder ge√∂ffnet. #NoBorderAction #Aachen	OTHER	OTHER
Und ich denke, ihr seid doch schon wieder besoffen... DABEI IST DOCH EURE MUDDA SCHON BEIM ZEUGUNGSFICK BESOFFEN AUSM BEICHTSTUHL GEFALLEN!!	OFFENSE	PROFANITY
@pip_news @AlexF50451971 Am besten finde ich Punkt 6- Wenn das Verfassungsfeindlich ist , dann bin ich auch ein Verfassungsfeind. Die ticken doch nicht mehr sauber.	OFFENSE	INSULT
So ihr abgehalfterten SCHLABBERPUSSIS von der S√ºderstrasse!! |LBR| Es ist soweit!! |LBR| M√§dels ab K√∂rbchengr√∂sse E nach vorne |LBR| ZUM ABSINGEN DER GRIESONALHYMNE!!	OFFENSE	ABUSE
Morgen beginnen #NoBorderAction Days in #Aachen. AZ ge√∂ffnet ab 15h. Um 16 Uhr gibts Workshops& rechtl. Input & Abends Konzert. #NoBorders	OTHER	OTHER
@HolgerSiebert2 @welt Das h√§tte ich gerne von einer unabh√§ngigen Stelle best√§tigt, und nicht vom #Hofjuden selbst!	OFFENSE	ABUSE
F√ºr heute empfehlen wir diese Veranstaltung: |LBR| Den Wandel feiern in der WandelBAR	OTHER	OTHER
@Paeddy1994_yt @kanak68ers Kommst du aus Berlin oder Duisburg?üòÇüòÇ	OTHER	OTHER
Wie immer an Halloween ist auch heute wieder mit einem vermehrtem Aufkommen rassistischer & faschistischer Deppen in #Aachen Innenstadt zu rechnen. Haltet die Augen offen & passt auf euch auf! #NaziWatchAC #Neonazis #Kaltland	OFFENSE	INSULT
@krippmarie Hinweg mit dem gr√ºnen Unflat!	OFFENSE	ABUSE
Zum Nachmittag hin k√∂nnte es morgen Regen geben. Denkt an warme & regentaugliche Kleidung, der Tag wird lang! #Linnich #Li2606 #AntifaNRW	OTHER	OTHER
@krippmarie @merdeux_ @China_Welt_News Mein herzlichstes Beileid und m√∂ge/n der/die T√§ter in der H√∂lle verrotten.	OFFENSE	ABUSE
@bruesteguckerin Ich GEB Ihnen gleich Kosenamen, Sie weibliche TITTENGLOTZUNGSAUSBILDUNGSFACHASSISTENZPR√úFERIN!	OFFENSE	ABUSE
@Karl_Lauterbach Spannend. |LBR| Klein-Karl ist ja angeblich auch Arzt und kritisiert jetzt die √Ñrzte, die die politisch motivierten Grenzwerte als Unsinn bezeichnen. |LBR| Was f√ºr ein Arzt ist Klein-Karl eigentlich?!?	OFFENSE	INSULT
@jouwatch Die Dummheit kommt bei ihr schon aus allen Poren	OFFENSE	INSULT
Deutsche werden von einer legalen Mafia Institution regiert	OFFENSE	ABUSE
Schon die Selbstbezeichnung ‚Äûgr√ºn‚Äú ist eine L√ºge im Parteinamen der Gr√ºnen. Tats√§chlich sind sie zu Beginn der 80er aus der gut organisierten RAF-Unterst√ºtzerszene entstanden. √ñkologie ist nur deren Verpackung. Das wahre Ziel bleibt die Zerschlagung der b√ºrgerlichen Gesellschaft.	OFFENSE	ABUSE
@TommyBlfd @Maulwerker1 @UrsulaNeumann16 Ja Danke Merkel die gr√∂√üte Verr√§terin gr√∂√üer als Adolfo	OFFENSE	ABUSE
@DonJoschi Merkel ist doch durch Ihre Stasi Methoden doch bekannt hat die nichts anderes in Ihrem Leben gemacht	OFFENSE	ABUSE
@axel_magnus Bei linksfaschistischen Wirrk√∂pfen ist ja alles, was nicht mindestens sozialistisch ist, #Nazi.	OFFENSE	ABUSE
@DrDavidBerger @taz_news @BfV_Bund Nicht nur die TAZ . Gleich alle Abonennten mit. Alles Linksfaschisten und Linksextreme Terror Unterst√ºtzer.	OFFENSE	ABUSE
@jutta_ditfurth Ach , die Ditfut kann schreibenüòÇüòÇ	OFFENSE	INSULT
@Beatrix_vStorch @SEENOTRETTUNG Da brat mir einer eine Storch! Zuviel Am Auspuff deines Dieselgenerators genuckelt, #Trixie?	OFFENSE	INSULT
@Eddie_1412 @PauleHasi13 @peteraltmaier Der hat ja auch einen begehbaren K√ºhlschrank!	OFFENSE	INSULT
@de_sputnik Der kann und wird nicht stattfinden	OTHER	OTHER
Ist hier noch irgendjemand von der alten Twitter-Garde √ºbrig?! |LBR| Oder hat man euch Pisser schon alle beerdigt?	OFFENSE	PROFANITY
Keine Ahnung, was es daran zu feiern gibt, dass sich einmal im Jahr ein paar tausend Dresdner fast einen Kilometer entfernt von Pegida ‚Äûgegen‚Äú Pegida positionieren? Das ist kein Gegenprotest gewesen. Sorry. #dd2110 #herzstatthetze	OTHER	OTHER
@Connybub So ein Dreckspack muss weg f√ºr immer alle ab nach Sibirien ohne Fressen ohne Wasser	OFFENSE	ABUSE
+++ALERTA+++ALERTA+++ |LBR| Da ich selber nicht da sein kann, hier ein Aufruf f√ºr einen Spendenlauf der besonderen Art: |LBR| F√ºr |LBR| jede kaputte Nazi-Nase 50ct |LBR| jeden Nazi der/die im RtW landet 1,- |LBR| als Direktspende von mir an die Rote Hilfe! |LBR| Bildnachweis erw√ºnscht! |LBR| #c2708 |LBR| #Chemnitz |LBR| #dankeAntifa	OFFENSE	ABUSE
Wie feiert mal eigentlich so einen #Frauentag?!? |LBR| Und h√§tte man / frau nicht besser einen Termin im Sommer nehmen k√∂nnen, dann k√∂nnte man sch√∂n im Bikini feiern?!?	OFFENSE	ABUSE
@Karlchen0815 @EngelGert @FredKrger2 @Ich_hake_nach @Trinchen312 @_Migraene_ @Grace30714933 @CoYoSilver @ph_phanuel @RalfTHeuer @Venum27004632 @chris_98763 @ChisNoria @assassina36 @wellejena @Bibby182 @bine1007 @Iamcovar @AufgewachteWelt @Lukas64F @Ron1872 @Ungebeten1 @PTroll3 @_Apuleius @LouisPeterle @machata9 @n59_puppche @KoyamaMichi @Cherylli18 @BoteDesUnrechts @ASiegwart @freitweeter @OdmantSuperstar @Lanyihunter1 @smuelle26677552 @MaXanonymous @Johannes135 @Connybub @heidi1274 @pseudros @Strandvogt3 @MadameSchwarzi @Hausfrau4ever @Robert19594 @Invictu53409591 @Vigilant__A @estathor @Metalwilli @willplaat @2018Wahrheit Dachte mir schon so etwas. |LBR| Die linksgr√ºnen Deppen fliehen vor dem was sie angerichtet haben und usurpieren den n√§chsten Landstrich. |LBR| Eine menschliche Pest ... |LBR| Widerlich.	OFFENSE	ABUSE
@_nasir_ahmad_ Bin ich rechts wenn ich der denke , das eine Vermischung der V√∂lker nicht wie jetzt stattfinden darf in dem man versucht ,Kulturen zu zerst√∂ren zugunsten irgendwelcher Kriminellen Religionen die von kriminellen Regierungen manipuliert werden um ein Volk leichter zu manipulieren ?	OFFENSE	ABUSE
@Ralf_Stegner Hahahaha.........Ralle Du Witzbold,wer nimmt Dich noch ernst??ü§™ü§™ü§£ü§£	OFFENSE	INSULT
@extra3 @guehart Ich halte dagegen. Wenn #Maa√üen f√ºr die #AfD antritt Spende ich 20‚Ç¨ an @exitdeutschland |LBR| #Maa√üenistweg #fckAfd #NoNazis	OFFENSE	INSULT
Gemessen an den Kommentaren wird der deutsche Edel-Fan wieder einen Ausl√§nder zum S√ºndenbock f√ºr das Ausscheiden der eigenen Mannschaft k√ºren, ausnahmsweise kein T√ºrke!üòÇüòÇ#GERNOR	OTHER	OTHER
@petra58249513 @IsidorMeyer1 @Alice_Weidel Die Richter sind politisiert. Sprechen kein Recht mehr. Und damit kriminell.	OFFENSE	INSULT
Habe f√ºr drei Nachbarn Pakete angenommen. |LBR| Sie haben Zettel an den T√ºren mit der Aufschrift: |LBR| EURE SCHEISSE FINDET IHR IN DEN M√úLLTONNEN!!	OFFENSE	PROFANITY
@rbrinkhaus @cducsubt @rponline Lasst mal die Kirche im Dorf. Es war eben doch nicht eine rechte Verschw√∂rung oder der b√∂se Russe oder ein Super-Hacker, sondern nur ein 20j√§hriges Milchgesicht, der aus dem Kinderzimmer bei seinen Eltern heraus mit stupiden Passw√∂rtern ‚Äûgesicherte‚Äú Promi-Konten geknackt hat.	OFFENSE	INSULT
@Juergen_Fritz @Dieter_Stein @SteinbachErika ‚ÄûSie verachten die, die Ihren Asyl gew√§hren!‚Äú Auf Grund wessen? Was stellen islamische Staaten und Menschen HEUTE auf die Beine??? WISSENSCHAFT, POLITIK, WIRTSCHAFT, KUNST, SPORT = √ºberall Fehlanzeige! Sie selbst hier meist ungebildet und kriminell. Da kann man aber stolz sein!	OFFENSE	ABUSE
Spontane Demonstration f√ºr Erhalt d. #HambacherForst & sofortigen R√§umungs- & Rodungsstopp auch in #Aachen! Heute um 19 Uhr am Marktplatz in #Aachen! Gemeinsam f√ºr den Hambi auf die Stra√üe! #hambibleibt	OTHER	OTHER
@AF_Will @publizistikon Die Evangelische Kirche ist schon seit Jahren zu einer Sozialarbeiter-Dienstleistungsgesellschaft mutiert! Keine Spiritualit√§t!	OFFENSE	INSULT
@sunnyboytande @uwegensheimer Warum antwortest du mir nicht? Ich bin Sportangler, und einsam!üòÇüòÇ	OTHER	OTHER
@krippmarie @jouwatch Es vergeht ja echt kein Tag mehr wo diese SPD, die Linken und die Gr√ºnen nicht mit total bescheuerten , verfassungsfeindlichen , provokativen Forderungen aus dem Strauch kommen. Die provozieren B√ºrgerkrieg.	OFFENSE	ABUSE
Passt heute wg. abreisender Besucher* d. #Rechtsrock-VA im belg. #Malmedy im Raum #Aachen/ #Verviers/ #Eupen auf! #NaziWatchAC #naziwatch	OTHER	OTHER
In 20min beginnt Spiel v.#Aachen in #Mgladbach (Bis 21.15); Danach ist auch mit Gruppen rechter Hools in AC-City zu rechnen. #NaziWatchAC	OTHER	OTHER
Warum steht am Eingangstor des Lagers eigentlich "Arbeit macht frei"?ü§î #WeRemember	OTHER	OTHER
00:02 An alle Aktivist*innen da drau√üen! Falls noch jemand einen Anlaufpunkt braucht: das AZ #Aachen steht weiterhin & bis mind. 2 Uhr zur Verf√ºgung, hier gibts warmes Essen & Getr√§nke zur St√§rkung f√ºr alle die es ben√∂tigen. #hambacherforst #hambibleibt @HambiBleibt @HambiEA	OTHER	OTHER
@StSchilling75 @Cha_Knobloch Geht eine Wahl nicht nach dem Wunsch der Deutschen aus, muss es sich nat√ºrlich um Wahlbetrug handeln, liegt vielleicht daran dass man selbst die Opposition unterst√ºtzt hat um dem t√ºrkischen Volk das Schicksal der Syrer, Libyer oder Iraker zu bescheren! #Heuchler	OFFENSE	INSULT
@Thorste1499 Und als Antwort auf deine Frage: Widerw√§rtig ist es, anderen Menschen vorzuwerfen "ihr eigenes Leid bestm√∂glich auszuschlachten" nachdem sie nach einem Angriff schwerst verletzt andere Menschen √ºber die Medien informieren.	OFFENSE	INSULT
Sitze im Restaurant des s√§chsischen Landtags. Mit Bier den Schreck runtersp√ºlen, als AfD MdL Barth das Wort erhielt. üò¨	OTHER	OTHER
Laut marokkanischer Bekannte sei ein beliebter Trick unter Landsleuten: |LBR| - Ausweis als verloren melden und einen neuen (zweiten) Pass in der Heimat mit kleiner Korrektur des Vor- oder Nachnamens beantragen |LBR| - damit in der Nachbarstadt unter Scheinadresse ein 2. Hartz4 beantragen.	OFFENSE	ABUSE
Diese Woche im AZ: |LBR| 20.06. Schwarz-Rote Kneipe: Hausbesetzungen - Was ist das? ab 18:30 Uhr |LBR| 21.06. Die ideale T√ºrkin - Frauen bei den Grauen W√∂lfen ab 18:30 Uhr |LBR| 23.06. Egotronic + Dave & Mighty - AZ Aachen ab 20:00 Uhr	OTHER	OTHER
@niklas_franzen So sind Faschisten! Auch hier! Hier nennen sie sich #AfD! #NazisRaus	OFFENSE	ABUSE
@PaulDHonest @MedzeraJ @Roland_Ecke @MalteKaufmann Welche Grenzen wurden denn aufgemacht?	OTHER	OTHER
@CharlieMayVuele @GretaThunberg Oder als rechts, wenn man die Kampagne, der diese Klimaschutz-Ikone vorsteht, kritisch hinterfragt!	OTHER	OTHER
@vaumue @emrich_5933 Total charakterlich und moralisch verwahrloster Mob! - Unsere ‚ÄûSuper-Medien‚Äú machen munter mit!!	OFFENSE	INSULT
@DirtyTalkHannah DAS IST DOCH IHR CLUB, Sie alte NAPFS√úLZE! |LBR| hat man mir erz√§hlt.	OFFENSE	INSULT
@StrawbewyVGCake Ich helfe auch gerne im aufs maul zu geben. Wenn das irgendwelche dummen Gamer in ‚Äûihrer Argumentation‚Äú st√ºtzt, mir egal. Die sind halt eh Schmutz.	OFFENSE	INSULT
@MalteKaufmann Unsere ganze Politik und Gesetzgebung ist ein Kasperle Theater lauter unf√§hige Gro√ümaulfr√∂sche	OFFENSE	INSULT
Kardinal Woelki solltest du nicht erst mal deine Kriminelle P√§dophile Kinder Vergewaltiger st√§te den Vatikan einlarven , oder hast du Angst das du dann deinen eigenen gebauten Vatikan dann zur√ºckzahlen musst ?	OFFENSE	ABUSE
Ich geh spazieren. Bauknecht Hotline war der Albtraum. |LBR| Die wollten die ganze Zeit √ºber Verl√§ngerungsgarantien sprechen. |LBR|  |LBR| ICH WILL EINEN TECHNIKER. Einer, der feststellen kann, wo das Problem liegt. An meinem Anschluss oder am Ger√§t. Ist das, verdammt noch mal so schwer?	OFFENSE	PROFANITY
@OlliLuksic Die Chance vertan! Die CDU hat wie immer der K√∂nigin gehorcht: Standingovations, Gehorsam und die eigene Karriere √ºber alles im Fokus. Das Merkel-Weibernetzwerk hat gesiegt! Jetzt kann diese Kanzlerin geruhsam SO WEITER machen! Ob das f√ºr die CDU und Deutschland gut ist?	OFFENSE	INSULT
@GrafSpee8 @profraika Wenn ich solche dreckigen Schweine sehe , dann √ºberkommt mich der blanke, ungez√ºgelte Hass aud solche unmenschlichen Kreaturen.	OFFENSE	ABUSE
@MalteKaufmann @berlinale Der Typ ist ein √ºbler Linkspopulist . Dieses Angebot ist eine arrogannte Frechheit und Unversch√§mtheit. Wir k√∂nnten ihn ja mal einladen sich Filme √ºber wirkliche Nazus anzusehen , damit der merkt wie dumm sein Gesaber ist und damit er mal lernt was wirkliche Nazis sind.	OFFENSE	ABUSE
@66Norweger66 Unerh√∂rter Skandal! Diese alte, verbitterte Frau geh√∂rt aus dem Saal entfernt‚ÄºÔ∏è‚ÄºÔ∏è	OFFENSE	INSULT
Halbschwester ist auch nur ein salonf√§higer Ausdruck f√ºr FICKFEHLER!!!	OFFENSE	PROFANITY
@deutsch365 Da kann man nur sagen , das hier hoffentlich die USA da rein gehen und dieses Linke Pack in die H√∂lle jagen.	OFFENSE	ABUSE
Spannende Frage. |LBR| Ist es angesichts des koordinierten Angriffs auf die b√ºrgerlichen #Freiheiten mittels eines erfundenen "#Klimawandel", berechtigt hier von einem politischen #Klimafaschismus zu sprechen? |LBR| Oder ist dieser Begriff zu sehr verharmlosend?	OFFENSE	ABUSE
Dieser Montag ist eine verrostete, ukrainische Babyklappe unter den Wochentagen!!	OFFENSE	PROFANITY
Juhu, eine weitere linke Gruppe aus #Aachen ist auf twitter: Folgt doch mal @Diskursiv_AC f. aktuelle Infos & Veranstaltungsank√ºndigungen!	OTHER	OTHER
Mal ganz abgesehen davon, wie hastig dieses ‚ÄûGespr√§ch‚Äú innerhalb von weniger als 24h und zu einer unm√∂glichen Zeit angesetzt wurde. Das ist ja auch nochmal ein Zeichen f√ºr sich.	OTHER	OTHER
Ist Vollmond? Frage f√ºr einen Freund üôÑ	OTHER	OTHER
@UllaJelpke Abgehafterte Pornodarstellerin,wird zeit das diese Kreatur gel√∂scht wird!	OFFENSE	ABUSE
Und wenn ich JEMALS irgendwem noch VOR @realDonaldTrump auf die SCHNAUZE HAUE, dann ist es der VOLLPFOSTEN aus der @trivago Werbung!	OFFENSE	ABUSE
@BILD Der letzte verzweifelte Versuch beim Dumm-Volk die Panik auszul√∂sen!üòÇüòÇ	OFFENSE	INSULT
Sie f√§llt dem Sozialstaat nicht zur Last. Ausl√§nderbeh√∂rde greift durch! Kanadierin wird ausgewiesen!ü§£#unfassbar	OTHER	OTHER
Um 19 Uhr geht es weiter: |LBR| Halloween Aftershow im AZ! |LBR| -Melodic Hardcore Emo Geballer- |LBR| mit Valley+Worth	OTHER	OTHER
19:24 Demo starts now via B√ºchel. 800 people now. All silent. Demo startet nun √ºber B√ºchel. Mehr als 800 Menschen jetzt. Alle still. #hambacherforst #hambiBleibt #Aachen	OTHER	OTHER
Der Gedanke, noch spontan zum SPD Landesparteitag zu fahren, aber als Abrissbirne ü§î	OFFENSE	INSULT
@Holger56228648 @ichbinkoelnerin Jo maximal von einem Affen aber selbst die sind schlauer wie diese Kreatur	OFFENSE	INSULT
@Einzelfallinfos Fuckbook ist der letzte Scheiss!!	OFFENSE	PROFANITY
@GoldfischLassa1 @PamelaCostaric1 Hart ist das ewige fordern dieser Wirtschaftsfl√ºchtlinge die hier eigentlich gar nicht mehr zu suchen haben. Hart ist ,das der noch nicht abgeschoben wurde. Das sind genau die richtigen Signale. Wenn sich das rumspricht , werden es weniger. Solidart√§t mit dem Amtsleiter	OFFENSE	ABUSE
@UllaJelpke Wird zeit das man Sie auf Hartz 4 setzt!	OFFENSE	INSULT